函数相关:
    - 函数的参数传递|function_pass_parameter
    - 函数的运行原理|function_principle
    - 递归的原理:factorial|factorial
    - 递归-科赫曲线|koch_curve
排序算法:
    - 冒泡排序|bubble_sort
    - 快速排序|quickSort
    - 归并排序-原理|merge_sort_principle
    - 归并排序|merge_sort
搜索算法:
    - 迷宫-DFS-找出是否有解|maze_dfs
    - 迷宫-DFS-找出有多少解|maze_dfs2
    - 迷宫-DFS-输出所有解|maze_dfs3
    - 迷宫-BFS|maze_bfs
    - 4/8皇后-游戏-DFS|4queen1
    - 4皇后-演示-找出所有方案|4queen2
    - 8皇后-演示-找出一种方案|8queen
    - 八数码-BFS|8numbers
分治算法:
    - lower_bound|m
    - upper_bound|m
动态规化:
    - LIS最长不下降子序列|LIS
    - LCS最长公共子序列|LCS
    - 石子合并|stone_dp
背包专题:
    - 01背包二维|01Knapsack
    - 01背包一维|01Knapsack1
    - 完全背包|total_knapsack
    - 混合三种背包|mix_knapsack
    - 多重背包|multiple_knapsack
    - 无界背包|m
    - 二次背包|m
    - 分组背包|m
树:
    - 森林转二叉树|m
    - LCA离线算法-tarjan|lca-tarjan
    - LCA在线算法|lca-rmq
    - 最小生成树-Prim|prim
    - 最小生成树-Kruskal|m
    - 线段树-建树|segment_tree_build
    - 线段树-单点更新|segment_tree_range_update
    - 线段树-区间查询|segment_tree_range_update
    - 线段树-区间更新|segment_tree_range_update
图论:
    - Floyed-WarShall|Floyed-WarShall
    - Dijkstra|Dijkstra
    - Bellman-ford|Bellman-ford
    - SPFA|SPFA
    - 二分图-最大匹配|m
    - 二分图-最佳匹配|bipartite_graph_best_match
其它:
    - 递归-黄金螺旋|Golden_Spiral
    - 生命游戏-Life Game|lifeGame
